{
  "tile_size": 32,
  "tiles": [
    "................................................................................",
    ".........................CC...........C.........................................",
    ".......................E.C............C.....C......C............................",
    "..........C........#...###_S......C...CE.__CE......E............................",
    "....C.....C....CE.......C..CC.....C...########....SS.##..C.......C..............",
    "P.E_C.....S.S__##......EC...C...._SS................EC...E......EC........C.....",
    "SSSSSS...C.......S..._SSS_.##_S.......C.....C....C..####_S.S....SS_..C....E....",
    "#######..E..........C.................C.....E..._#.......C...........C..__S_....",
    "###########.EC.....CC...........C..E..##.._SSS...........CC...S_.....S....C...G.",
    "##############.E...###C...CC....##_SS....C........CC.....###.......C......C.......",
    "###########....SS_....CE..CE.C.........E.C.CCE...SSS...............CE.....SS....",
    "###########...........###_SS_S.........#########...................###_#........."
  ]
}
