{
  "tile_size": 32,
  "tiles": [
    "..............................CC................................................",
    "................................CE..............................................",
    "...........................CE.#.SS..............................................",
    ".........................._##...............CCC.................................",
    ".....C..CE...........EC..C..................C.C........CE.C.....................",
    "P....C__SS.C.....C...##_.S_.............C...S.S.........S_S..........G...........",
    "#..__#####_S.....C..E...........C....S..E.........CC.E.....C...................",
    "##.._S...#....C..#_SS......C...CE...C...##_........S_SS....C.......C............",
    "###.C....C....CE.......CC..E...SS.._#............CE......_##_..EC..C.C..........",
    "#######_SS.._###.......SS_##.....................##............SS__#_#...........",
    "###########................................CEC...................................",
    "###########................................SSS_#................................."
  ]
}
