{
  "tile_size": 32,
  "tiles": [
    "................................................................................",
    "..........CC...........C.....C..............C...C..........C.........C..........",
    "........S_S.._#....E..CE.....C.E.C.E..#_....E...EC..E......CE.......C.C.........",
    ".......C........._SS..##_..S.S_S_S_S.......###__SS..S......SSS......S_S........G",
    "......EC...CE.........C..................#..............CE.....C...#.......C....",
    "P.CE.SSS...SS_.#.......C..CE....C.....CCE.......CC....._SS_....C......C...C....",
    "#C_#....#.........E..###..SSS...C.....SSS.....C####...S......__SS..C#.#..C#__...",
    "#CSSS.....C...CC..SS....#.......S...C_......C.#.......C....C.......EC....C......",
    "#CSSS.EC...CC.##.#.............S....#....C._#....C....E...CEC.....SS_S...#.....",
    "#CSCCC##.S._S.....C...E...C........C.....#_.....CE..._##_.###...C......C..CCE...",
    "#CE_######C..E...CCSS_#..SS_....C..E.C..##....C.SS_S...........C.C....##__SSS...",
    "###########._#._SSS....##..._#..SS_####......##_...............SSS.#.#..........."
  ]
}
