{
  "tile_size": 32,
  "tiles": [
    "................................................................................",
    ".......................C........................................................",
    "..............CE.......C........................................................",
    "..............###......CE.......................................................",
    ".........C...#........SSSS.........C......................C...............G.....",
    "........EC................C........C.......................C....................",
    "P..CC.SSSS.....C..........C........#_S....C......C.......#_S....................",
    "############...C........S_S......E.......C......CC.E...................C........",
    "###########..._#...C#..........S.##....#_##.___.SSSS...#.........E..SS.C........",
    "###########........CC................C...............C.._#...S...S_#####........",
    "###########.......#####.......CE....##...............C...C..S...................",
    "###########...................SSS....................########..................."
  ]
}

